#################
#..,,,,,,,,,,,,##
#.#,#,#,,,#,,##,#
#,,#,,,,#,,#,,,,#
#,,,#,#,#,#,#,#,#
#,,,,,#,,#,,,,,,#
#,#,,,#,#,#,#,,,#
#,,#,,,,,,,,,,,,#
#,##,,#,#,,,###,#
#,,#,,,,,#,,,,,,#
#,#,#,#,#,,#,,#,#
#,,,,,,,,,,#,,,,#
#,#,#,###,,,#,#.#
##,,,,,,,,,,,,..#
#################