##############################
#............................#
#............................#
#.....,,,,,,.................#
#.....,,,,,,.................#
#.......,....................#
#.......,....................#
#..........###...............#
#............................#
#............................#
#............................#
#............................#
#............................#
#............................#
#............................#
#............................#
##############################