#################
#..,,,,,,,,,,,,##
#.#,#,#,#,#,###,#
#,,#,,,,,,,#,,,,#
#,#,#,#,#,#,#,#,#
#,,,,,,,,#,,,,,,#
#,#,,,#,#,#,#,#,#
#,,,,,,,,,,,,,,,#
#,#,,,#,#,#,#,#,#
#,,,,,#,,,,,,,,,#
#,#,#,#,#,,,#,#,#
#,,,,,,,,,,,,,,,#
#,#,#,###,,,#,#.#
##,,,,,,,,,,,,..#
#################