##############################
#............................#
#...,,,,,,,,,,...............#
#.....,,,#,,.................#
#.....,,,#,,,,,,.............#
#.......,.###,,,,,...........#
#.......,,,,,,,,.............#
#..........###...............#
#........,,,,,,..............#
#............................#
#............................#
#............................#
#............................#
#............................#
#............................#
#............................#
##############################