#############################
#..,,,,,,,,,,,,,,,,,,,,,,,,,#
#.#,#,#,#,#,#,#,#,#,#,#,#,#,#
#,,,,,#,#,#,#,#,#,#,#,#,#,#,#
#,#,#,#,#,#,#,#,#,#,#,#,#,#,#
#,,,,,#,#,#,#,#,#,#,#,#,#,#,#
#,#,#,#,#,#,#,#,#,#,#,#,#,#,#
#,,,,,#,#,#,#,#,#,#,#,#,#,#,#
#,#,#,#,#,#,#,#,#,#,#,#,#,#,#
#,,,,,#,#,#,#,#,#,#,#,#,#,#,#
#,#,#,#,#,#,#,#,#,#,#,#,#,#,#
#,,,,,#,#,#,#,#,#,#,#,#,#,#,#
#,#,#,#,#,#,#,#,#,#,#,#,#,#,#
#,,,,#,#,#,#,#,#,#,#,#,#,#.#
#,#,,,,,,,,,,,,,,,,,,,,,,,,..#
#############################