##########
#........#
#........#
#...###..D
#.....#..###################
#.....#....................#
#####D######################