##########
#........#
#........#
#.....#..#
#.....#..#
#.!......#
##########