WWWWWWWWWWWWWWWWW
W..,,,,,,,,,,,,#W
W.#,#,#,,,#,,##,W
W,,#,,,,#,,#,,,,W
W,,,#,#,#,#,#,#,W
W,,,,,#,,#,,,,,,W
W,#,,,#,#,#,#,,,W
W,,#,,,,,,,,,,,,W
W,##,,#,#,,,###,W
W,,#,,,,,#,,,,,,W
W,#,#,#,#,,#,,#,W
W,,,,,,,,,,#,,,,W
W,#,#,###,,,#,#.W
W#,,,,,,,,,,,,..W
WWWWWWWWWWWWWWWWW