##############################
#............................#
#............................#
#............................#
#............................#
#............................#
#............................#
#..........###...............#
#............................#
#............................#
#............................#
#............................#
#............................#
#............................#
#............................#
#............................#
##############################