##########
#........#
#........#
D.....#..#
#.....#..#
#.!......#
##########