#################
#..,,,,,,,,,,,,##
#.#,#,#,,,#,###,#
#,,#,,,,,,,#,,,,#
#,,,#,,,#,#,#,#,#
#,,,,,,,,#,,,,,,#
#,#,,,#,#,#,#,,,#
#,,,,,,,,,,,,,,,#
#,#,,,#,#,,,,,,,#
#,,,,,,,,#,,,,,,#
#,#,#,#,#,,#,,#,#
#,,,,,,,,,,#,,,,#
#,#,#,###,,,#,#.#
##,,,,,,,,,,,,..#
#################