#############################
#..,,,,,,,,,,,,,,,,,,,,,,,,,#
#.#,#,#,#,#,#,#,#,#,#,#,#,#,#
#,,,#,#,#,#,#,#,#,#,#,#,#,#,#
#,,,#,#,#,#,#,#,#,#,#,#,#,#,#
#,#,#,#,#,#,#,#,#,#,#,#,#,#,#
#,#,#,#,#,#,#,#,#,#,#,#,#,#,#
#,#,#,#,#,#,#,#,#,#,#,#,#,#,#
#,#,#,#,#,#,#,#,#,#,#,#,#,#,#
#,#,#,#,#,#,#,#,#,#,#,#,#,#,#
#,#,#,#,#,#,#,#,#,#,#,#,#,#,#
#,#,#,#,#,#,#,#,#,#,#,#,#,#,#
#,#,#,#,#,#,#,#,#,#,#,#,#,#,#
#,#,#,#,#,#,#,#,#,#,#,#,#,#.#
#,,,,,,,,,,,,,,,,,,,,,,,,,..#
#############################